111111111111111111111111
1C000C0001C00C010C0010F1
1101111101001111111C1001
11010C1001001C00C00000C1
11P10110110F111F11011111
1C0101C010C00C1000E00C01
1101C1101011101011011111
1C01000C001C00101C0001C1
1011001111111010111C0001
1C100C10C01000C01C1101C1
101C001C0000C00010C0C101
111111111111111111111111