111111111111
1F0000000001
1000F000F001
100000000001
100C0EP0F001
1F000000F001
100F00000001
111111111111