111111111111111111111111
1C000C0001C00C010C000101
1101111101001111111C00C1
11010C10010C1C00C0000101
11P101101100111011011111
1C0101C010C00C1000E00C01
1101C1101011101011011111
1C01000C001C00101C0001C1
1011001111111010111C0001
1C100C10C01000C01C1101C1
101C001C0000C00010C0C101
111111111111111111111111