1111111111111111111111
1C000C0001C00C010C0001
1101111101001111111C01
11010C10010C1C00C00001
11P1011011001110110111
1C0101C010C00C1000E0C1
1101C11010111010110111
1C01000C001C00101C0C01
10110C1111111010111101
1C1C0010C00000C000C001
1111111111111111111111