11111
1CPC1
1CCC1
1CC11
1C111
1ECC1
1CCC1
11111
