111111111111
100000000001
100000000001
100000000001
100C0EP10001
100000000001
100000000001
111111111111