111111
1E0001
1100C1
1P0001
111111