1111111111111111111111
10C0000C00000000C000P1
1011111111111111111111
101C0000C0000C00000001
1C10111111111111111101
10101E000C00000C0001C1
1010111111111111110101
101000C000000C0000C101
1011111111111111111101
1C000000000C0000000C01
1111111111111111111111