11111111111111111111111111111
1000E000000000000000000000001
10000000000000000000000000001
1P00000C00F00000F000000000001
1000C000000000000000C00000001
10F000000000F0000000000000001
100000000000000000C00000000F1
11111111111111111111111111111